id`guild_boss1_wujiang_zhuansheng`guild_boss1_wujiang_level`guild_boss2_wujiang_zhuansheng`guild_boss2_wujiang_level`guild_boss3_wujiang_zhuansheng`guild_boss3_wujiang_level`guild_boss4_wujiang_zhuansheng`guild_boss4_wujiang_level`guild_boss5_wujiang_zhuansheng`guild_boss5_wujiang_level`guild_boss6_wujiang_zhuansheng`guild_boss6_wujiang_level`guild_boss_wujiang_soldier_count`guild_boss_amy_level:int`world_boss_turn_pnt`world_boss_soldier_count`world_boss_amry_level:int`worldboss_wujiang_zhuansheng`worldboss_wujiang_level
1`0|0|0|0|0|0|0|0|0|0|0|0|0|0|0|0|0|0`10|10|10|10|10|10|10|10|10|10|10|10|10|10|10|10|10|10`0|0|0|0|0|0|0|0|0|0|0|0|0|0|0|0|0|0`10|10|10|10|10|10|10|10|10|10|10|10|10|10|10|10|10|10`0|0|0|0|0|0|0|0|0|0|0|0|0|0|0|0|0|0`10|10|10|10|10|10|10|10|10|10|10|10|10|10|10|10|10|10`0|0|0|0|0|0|0|0|0|0|0|0|0|0|0|0|0|0`10|10|10|10|10|10|10|10|10|10|10|10|10|10|10|10|10|10`0|0|0|0|0|0|0|0|0|0|0|0|0|0|0|0|0|0`10|10|10|10|10|10|10|10|10|10|10|10|10|10|10|10|10|10`0|0|0|0|0|0|0|0|0|0|0|0|0|0|0|0|0|0`10|10|10|10|10|10|10|10|10|10|10|10|10|10|10|10|10|10`41690`3`30`41690`3`0`10
2`0|0|0|0|0|0|0|0|0|0|0|0|0|0|0|0|0|0`10|10|10|10|10|10|10|10|10|10|10|10|10|10|10|10|10|10`0|0|0|0|0|0|0|0|0|0|0|0|0|0|0|0|0|0`10|10|10|10|10|10|10|10|10|10|10|10|10|10|10|10|10|10`0|0|0|0|0|0|0|0|0|0|0|0|0|0|0|0|0|0`10|10|10|10|10|10|10|10|10|10|10|10|10|10|10|10|10|10`0|0|0|0|0|0|0|0|0|0|0|0|0|0|0|0|0|0`10|10|10|10|10|10|10|10|10|10|10|10|10|10|10|10|10|10`0|0|0|0|0|0|0|0|0|0|0|0|0|0|0|0|0|0`10|10|10|10|10|10|10|10|10|10|10|10|10|10|10|10|10|10`0|0|0|0|0|0|0|0|0|0|0|0|0|0|0|0|0|0`10|10|10|10|10|10|10|10|10|10|10|10|10|10|10|10|10|10`41690`3`30`41690`3`0`10
3`0|0|0|0|0|0|0|0|0|0|0|0|0|0|0|0|0|0`10|10|10|10|10|10|10|10|10|10|10|10|10|10|10|10|10|10`0|0|0|0|0|0|0|0|0|0|0|0|0|0|0|0|0|0`10|10|10|10|10|10|10|10|10|10|10|10|10|10|10|10|10|10`0|0|0|0|0|0|0|0|0|0|0|0|0|0|0|0|0|0`10|10|10|10|10|10|10|10|10|10|10|10|10|10|10|10|10|10`0|0|0|0|0|0|0|0|0|0|0|0|0|0|0|0|0|0`10|10|10|10|10|10|10|10|10|10|10|10|10|10|10|10|10|10`0|0|0|0|0|0|0|0|0|0|0|0|0|0|0|0|0|0`10|10|10|10|10|10|10|10|10|10|10|10|10|10|10|10|10|10`0|0|0|0|0|0|0|0|0|0|0|0|0|0|0|0|0|0`10|10|10|10|10|10|10|10|10|10|10|10|10|10|10|10|10|10`41690`3`30`41690`3`0`10
4`0|0|0|0|0|0|0|0|0|0|0|0|0|0|0|0|0|0`10|10|10|10|10|10|10|10|10|10|10|10|10|10|10|10|10|10`0|0|0|0|0|0|0|0|0|0|0|0|0|0|0|0|0|0`10|10|10|10|10|10|10|10|10|10|10|10|10|10|10|10|10|10`0|0|0|0|0|0|0|0|0|0|0|0|0|0|0|0|0|0`10|10|10|10|10|10|10|10|10|10|10|10|10|10|10|10|10|10`0|0|0|0|0|0|0|0|0|0|0|0|0|0|0|0|0|0`10|10|10|10|10|10|10|10|10|10|10|10|10|10|10|10|10|10`0|0|0|0|0|0|0|0|0|0|0|0|0|0|0|0|0|0`10|10|10|10|10|10|10|10|10|10|10|10|10|10|10|10|10|10`0|0|0|0|0|0|0|0|0|0|0|0|0|0|0|0|0|0`10|10|10|10|10|10|10|10|10|10|10|10|10|10|10|10|10|10`41690`4`30`41690`4`0`10
5`0|0|0|0|0|0|0|0|0|0|0|0|0|0|0|0|0|0`13|13|13|13|13|13|13|13|13|13|13|13|13|13|13|13|13|13`0|0|0|0|0|0|0|0|0|0|0|0|0|0|0|0|0|0`13|13|13|13|13|13|13|13|13|13|13|13|13|13|13|13|13|13`0|0|0|0|0|0|0|0|0|0|0|0|0|0|0|0|0|0`13|13|13|13|13|13|13|13|13|13|13|13|13|13|13|13|13|13`0|0|0|0|0|0|0|0|0|0|0|0|0|0|0|0|0|0`13|13|13|13|13|13|13|13|13|13|13|13|13|13|13|13|13|13`0|0|0|0|0|0|0|0|0|0|0|0|0|0|0|0|0|0`13|13|13|13|13|13|13|13|13|13|13|13|13|13|13|13|13|13`0|0|0|0|0|0|0|0|0|0|0|0|0|0|0|0|0|0`13|13|13|13|13|13|13|13|13|13|13|13|13|13|13|13|13|13`41690`5`30`41690`5`0`13
6`0|0|0|0|0|0|0|0|0|0|0|0|0|0|0|0|0|0`15|15|15|15|15|15|15|15|15|15|15|15|15|15|15|15|15|15`0|0|0|0|0|0|0|0|0|0|0|0|0|0|0|0|0|0`15|15|15|15|15|15|15|15|15|15|15|15|15|15|15|15|15|15`0|0|0|0|0|0|0|0|0|0|0|0|0|0|0|0|0|0`15|15|15|15|15|15|15|15|15|15|15|15|15|15|15|15|15|15`0|0|0|0|0|0|0|0|0|0|0|0|0|0|0|0|0|0`15|15|15|15|15|15|15|15|15|15|15|15|15|15|15|15|15|15`0|0|0|0|0|0|0|0|0|0|0|0|0|0|0|0|0|0`15|15|15|15|15|15|15|15|15|15|15|15|15|15|15|15|15|15`0|0|0|0|0|0|0|0|0|0|0|0|0|0|0|0|0|0`15|15|15|15|15|15|15|15|15|15|15|15|15|15|15|15|15|15`42158`6`30`42158`6`0`15
7`0|0|0|0|0|0|0|0|0|0|0|0|0|0|0|0|0|0`18|18|18|18|18|18|18|18|18|18|18|18|18|18|18|18|18|18`0|0|0|0|0|0|0|0|0|0|0|0|0|0|0|0|0|0`18|18|18|18|18|18|18|18|18|18|18|18|18|18|18|18|18|18`0|0|0|0|0|0|0|0|0|0|0|0|0|0|0|0|0|0`18|18|18|18|18|18|18|18|18|18|18|18|18|18|18|18|18|18`0|0|0|0|0|0|0|0|0|0|0|0|0|0|0|0|0|0`18|18|18|18|18|18|18|18|18|18|18|18|18|18|18|18|18|18`0|0|0|0|0|0|0|0|0|0|0|0|0|0|0|0|0|0`18|18|18|18|18|18|18|18|18|18|18|18|18|18|18|18|18|18`0|0|0|0|0|0|0|0|0|0|0|0|0|0|0|0|0|0`18|18|18|18|18|18|18|18|18|18|18|18|18|18|18|18|18|18`51941`7`30`51941`7`0`18
8`0|0|0|0|0|0|0|0|0|0|0|0|0|0|0|0|0|0`21|21|21|21|21|21|21|21|21|21|21|21|21|21|21|21|21|21`0|0|0|0|0|0|0|0|0|0|0|0|0|0|0|0|0|0`21|21|21|21|21|21|21|21|21|21|21|21|21|21|21|21|21|21`0|0|0|0|0|0|0|0|0|0|0|0|0|0|0|0|0|0`21|21|21|21|21|21|21|21|21|21|21|21|21|21|21|21|21|21`0|0|0|0|0|0|0|0|0|0|0|0|0|0|0|0|0|0`21|21|21|21|21|21|21|21|21|21|21|21|21|21|21|21|21|21`0|0|0|0|0|0|0|0|0|0|0|0|0|0|0|0|0|0`21|21|21|21|21|21|21|21|21|21|21|21|21|21|21|21|21|21`0|0|0|0|0|0|0|0|0|0|0|0|0|0|0|0|0|0`21|21|21|21|21|21|21|21|21|21|21|21|21|21|21|21|21|21`61886`8`30`61886`8`0`21
9`0|0|0|0|0|0|0|0|0|0|0|0|0|0|0|0|0|0`24|24|24|24|24|24|24|24|24|24|24|24|24|24|24|24|24|24`0|0|0|0|0|0|0|0|0|0|0|0|0|0|0|0|0|0`24|24|24|24|24|24|24|24|24|24|24|24|24|24|24|24|24|24`0|0|0|0|0|0|0|0|0|0|0|0|0|0|0|0|0|0`24|24|24|24|24|24|24|24|24|24|24|24|24|24|24|24|24|24`0|0|0|0|0|0|0|0|0|0|0|0|0|0|0|0|0|0`24|24|24|24|24|24|24|24|24|24|24|24|24|24|24|24|24|24`0|0|0|0|0|0|0|0|0|0|0|0|0|0|0|0|0|0`24|24|24|24|24|24|24|24|24|24|24|24|24|24|24|24|24|24`0|0|0|0|0|0|0|0|0|0|0|0|0|0|0|0|0|0`24|24|24|24|24|24|24|24|24|24|24|24|24|24|24|24|24|24`62517`9`30`62517`9`0`24
10`0|0|0|0|0|0|0|0|0|0|0|0|0|0|0|0|0|0`26|26|26|26|26|26|26|26|26|26|26|26|26|26|26|26|26|26`0|0|0|0|0|0|0|0|0|0|0|0|0|0|0|0|0|0`26|26|26|26|26|26|26|26|26|26|26|26|26|26|26|26|26|26`0|0|0|0|0|0|0|0|0|0|0|0|0|0|0|0|0|0`27|27|27|27|27|27|27|27|27|27|27|27|27|27|27|27|27|27`0|0|0|0|0|0|0|0|0|0|0|0|0|0|0|0|0|0`28|28|28|28|28|28|28|28|28|28|28|28|28|28|28|28|28|28`0|0|0|0|0|0|0|0|0|0|0|0|0|0|0|0|0|0`30|30|30|30|30|30|30|30|30|30|30|30|30|30|30|30|30|30`0|0|0|0|0|0|0|0|0|0|0|0|0|0|0|0|0|0`30|30|30|30|30|30|30|30|30|30|30|30|30|30|30|30|30|30`63149`10`30`63149`10`0`26
11`0|0|0|0|0|0|0|0|0|0|0|0|0|0|0|0|0|0`29|29|29|29|29|29|29|29|29|29|29|29|29|29|29|29|29|29`0|0|0|0|0|0|0|0|0|0|0|0|0|0|0|0|0|0`29|29|29|29|29|29|29|29|29|29|29|29|29|29|29|29|29|29`0|0|0|0|0|0|0|0|0|0|0|0|0|0|0|0|0|0`30|30|30|30|30|30|30|30|30|30|30|30|30|30|30|30|30|30`0|0|0|0|0|0|0|0|0|0|0|0|0|0|0|0|0|0`31|31|31|31|31|31|31|31|31|31|31|31|31|31|31|31|31|31`0|0|0|0|0|0|0|0|0|0|0|0|0|0|0|0|0|0`33|33|33|33|33|33|33|33|33|33|33|33|33|33|33|33|33|33`0|0|0|0|0|0|0|0|0|0|0|0|0|0|0|0|0|0`33|33|33|33|33|33|33|33|33|33|33|33|33|33|33|33|33|33`64727`11`30`64727`11`0`29
12`0|0|0|0|0|0|0|0|0|0|0|0|0|0|0|0|0|0`32|32|32|32|32|32|32|32|32|32|32|32|32|32|32|32|32|32`0|0|0|0|0|0|0|0|0|0|0|0|0|0|0|0|0|0`32|32|32|32|32|32|32|32|32|32|32|32|32|32|32|32|32|32`0|0|0|0|0|0|0|0|0|0|0|0|0|0|0|0|0|0`33|33|33|33|33|33|33|33|33|33|33|33|33|33|33|33|33|33`0|0|0|0|0|0|0|0|0|0|0|0|0|0|0|0|0|0`34|34|34|34|34|34|34|34|34|34|34|34|34|34|34|34|34|34`0|0|0|0|0|0|0|0|0|0|0|0|0|0|0|0|0|0`36|36|36|36|36|36|36|36|36|36|36|36|36|36|36|36|36|36`0|0|0|0|0|0|0|0|0|0|0|0|0|0|0|0|0|0`36|36|36|36|36|36|36|36|36|36|36|36|36|36|36|36|36|36`87164`12`30`87164`12`0`32
13`0|0|0|0|0|0|0|0|0|0|0|0|0|0|0|0|0|0`35|35|35|35|35|35|35|35|35|35|35|35|35|35|35|35|35|35`0|0|0|0|0|0|0|0|0|0|0|0|0|0|0|0|0|0`35|35|35|35|35|35|35|35|35|35|35|35|35|35|35|35|35|35`0|0|0|0|0|0|0|0|0|0|0|0|0|0|0|0|0|0`36|36|36|36|36|36|36|36|36|36|36|36|36|36|36|36|36|36`0|0|0|0|0|0|0|0|0|0|0|0|0|0|0|0|0|0`37|37|37|37|37|37|37|37|37|37|37|37|37|37|37|37|37|37`0|0|0|0|0|0|0|0|0|0|0|0|0|0|0|0|0|0`39|39|39|39|39|39|39|39|39|39|39|39|39|39|39|39|39|39`0|0|0|0|0|0|0|0|0|0|0|0|0|0|0|0|0|0`39|39|39|39|39|39|39|39|39|39|39|39|39|39|39|39|39|39`89239`13`30`89239`13`0`35
14`0|0|0|0|0|0|0|0|0|0|0|0|0|0|0|0|0|0`37|37|37|37|37|37|37|37|37|37|37|37|37|37|37|37|37|37`0|0|0|0|0|0|0|0|0|0|0|0|0|0|0|0|0|0`37|37|37|37|37|37|37|37|37|37|37|37|37|37|37|37|37|37`0|0|0|0|0|0|0|0|0|0|0|0|0|0|0|0|0|0`38|38|38|38|38|38|38|38|38|38|38|38|38|38|38|38|38|38`0|0|0|0|0|0|0|0|0|0|0|0|0|0|0|0|0|0`39|39|39|39|39|39|39|39|39|39|39|39|39|39|39|39|39|39`0|0|0|0|0|0|0|0|0|0|0|0|0|0|0|0|0|0`41|41|41|41|41|41|41|41|41|41|41|41|41|41|41|41|41|41`0|0|0|0|0|0|0|0|0|0|0|0|0|0|0|0|0|0`41|41|41|41|41|41|41|41|41|41|41|41|41|41|41|41|41|41`91314`14`30`91314`14`0`37
15`0|0|0|0|0|0|0|0|0|0|0|0|0|0|0|0|0|0`40|40|40|40|40|40|40|40|40|40|40|40|40|40|40|40|40|40`0|0|0|0|0|0|0|0|0|0|0|0|0|0|0|0|0|0`40|40|40|40|40|40|40|40|40|40|40|40|40|40|40|40|40|40`0|0|0|0|0|0|0|0|0|0|0|0|0|0|0|0|0|0`41|41|41|41|41|41|41|41|41|41|41|41|41|41|41|41|41|41`0|0|0|0|0|0|0|0|0|0|0|0|0|0|0|0|0|0`42|42|42|42|42|42|42|42|42|42|42|42|42|42|42|42|42|42`0|0|0|0|0|0|0|0|0|0|0|0|0|0|0|0|0|0`44|44|44|44|44|44|44|44|44|44|44|44|44|44|44|44|44|44`0|0|0|0|0|0|0|0|0|0|0|0|0|0|0|0|0|0`44|44|44|44|44|44|44|44|44|44|44|44|44|44|44|44|44|44`115735`15`30`115735`15`0`40
16`0|0|0|0|0|0|0|0|0|0|0|0|0|0|0|0|0|0`43|43|43|43|43|43|43|43|43|43|43|43|43|43|43|43|43|43`0|0|0|0|0|0|0|0|0|0|0|0|0|0|0|0|0|0`43|43|43|43|43|43|43|43|43|43|43|43|43|43|43|43|43|43`0|0|0|0|0|0|0|0|0|0|0|0|0|0|0|0|0|0`44|44|44|44|44|44|44|44|44|44|44|44|44|44|44|44|44|44`0|0|0|0|0|0|0|0|0|0|0|0|0|0|0|0|0|0`45|45|45|45|45|45|45|45|45|45|45|45|45|45|45|45|45|45`0|0|0|0|0|0|0|0|0|0|0|0|0|0|0|0|0|0`47|47|47|47|47|47|47|47|47|47|47|47|47|47|47|47|47|47`0|0|0|0|0|0|0|0|0|0|0|0|0|0|0|0|0|0`47|47|47|47|47|47|47|47|47|47|47|47|47|47|47|47|47|47`118307`16`30`118307`16`0`43
17`0|0|0|0|0|0|0|0|0|0|0|0|0|0|0|0|0|0`45|45|45|45|45|45|45|45|45|45|45|45|45|45|45|45|45|45`0|0|0|0|0|0|0|0|0|0|0|0|0|0|0|0|0|0`45|45|45|45|45|45|45|45|45|45|45|45|45|45|45|45|45|45`0|0|0|0|0|0|0|0|0|0|0|0|0|0|0|0|0|0`46|46|46|46|46|46|46|46|46|46|46|46|46|46|46|46|46|46`0|0|0|0|0|0|0|0|0|0|0|0|0|0|0|0|0|0`47|47|47|47|47|47|47|47|47|47|47|47|47|47|47|47|47|47`0|0|0|0|0|0|0|0|0|0|0|0|0|0|0|0|0|0`49|49|49|49|49|49|49|49|49|49|49|49|49|49|49|49|49|49`0|0|0|0|0|0|0|0|0|0|0|0|0|0|0|0|0|0`49|49|49|49|49|49|49|49|49|49|49|49|49|49|49|49|49|49`120879`17`30`120879`17`0`45
18`0|0|0|0|0|0|0|0|0|0|0|0|0|0|0|0|0|0`48|48|48|48|48|48|48|48|48|48|48|48|48|48|48|48|48|48`0|0|0|0|0|0|0|0|0|0|0|0|0|0|0|0|0|0`48|48|48|48|48|48|48|48|48|48|48|48|48|48|48|48|48|48`0|0|0|0|0|0|0|0|0|0|0|0|0|0|0|0|0|0`49|49|49|49|49|49|49|49|49|49|49|49|49|49|49|49|49|49`0|0|0|0|0|0|0|0|0|0|0|0|0|0|0|0|0|0`50|50|50|50|50|50|50|50|50|50|50|50|50|50|50|50|50|50`0|0|0|0|0|0|0|0|0|0|0|0|0|0|0|0|0|0`52|52|52|52|52|52|52|52|52|52|52|52|52|52|52|52|52|52`0|0|0|0|0|0|0|0|0|0|0|0|0|0|0|0|0|0`52|52|52|52|52|52|52|52|52|52|52|52|52|52|52|52|52|52`123451`18`30`123451`18`0`48
19`0|0|0|0|0|0|0|0|0|0|0|0|0|0|0|0|0|0`51|51|51|51|51|51|51|51|51|51|51|51|51|51|51|51|51|51`0|0|0|0|0|0|0|0|0|0|0|0|0|0|0|0|0|0`51|51|51|51|51|51|51|51|51|51|51|51|51|51|51|51|51|51`0|0|0|0|0|0|0|0|0|0|0|0|0|0|0|0|0|0`52|52|52|52|52|52|52|52|52|52|52|52|52|52|52|52|52|52`0|0|0|0|0|0|0|0|0|0|0|0|0|0|0|0|0|0`53|53|53|53|53|53|53|53|53|53|53|53|53|53|53|53|53|53`0|0|0|0|0|0|0|0|0|0|0|0|0|0|0|0|0|0`55|55|55|55|55|55|55|55|55|55|55|55|55|55|55|55|55|55`0|0|0|0|0|0|0|0|0|0|0|0|0|0|0|0|0|0`55|55|55|55|55|55|55|55|55|55|55|55|55|55|55|55|55|55`150357`19`30`150357`19`0`51
20`0|0|0|0|0|0|0|0|0|0|0|0|0|0|0|0|0|0`54|54|54|54|54|54|54|54|54|54|54|54|54|54|54|54|54|54`0|0|0|0|0|0|0|0|0|0|0|0|0|0|0|0|0|0`54|54|54|54|54|54|54|54|54|54|54|54|54|54|54|54|54|54`0|0|0|0|0|0|0|0|0|0|0|0|0|0|0|0|0|0`55|55|55|55|55|55|55|55|55|55|55|55|55|55|55|55|55|55`0|0|0|0|0|0|0|0|0|0|0|0|0|0|0|0|0|0`56|56|56|56|56|56|56|56|56|56|56|56|56|56|56|56|56|56`0|0|0|0|0|0|0|0|0|0|0|0|0|0|0|0|0|0`58|58|58|58|58|58|58|58|58|58|58|58|58|58|58|58|58|58`0|0|0|0|0|0|0|0|0|0|0|0|0|0|0|0|0|0`58|58|58|58|58|58|58|58|58|58|58|58|58|58|58|58|58|58`153426`20`30`153426`20`0`54
21`0|0|0|0|0|0|0|0|0|0|0|0|0|0|0|0|0|0`56|56|56|56|56|56|56|56|56|56|56|56|56|56|56|56|56|56`0|0|0|0|0|0|0|0|0|0|0|0|0|0|0|0|0|0`56|56|56|56|56|56|56|56|56|56|56|56|56|56|56|56|56|56`0|0|0|0|0|0|0|0|0|0|0|0|0|0|0|0|0|0`57|57|57|57|57|57|57|57|57|57|57|57|57|57|57|57|57|57`0|0|0|0|0|0|0|0|0|0|0|0|0|0|0|0|0|0`58|58|58|58|58|58|58|58|58|58|58|58|58|58|58|58|58|58`0|0|0|0|0|0|0|0|0|0|0|0|0|0|0|0|0|0`60|60|60|60|60|60|60|60|60|60|60|60|60|60|60|60|60|60`0|0|0|0|0|0|0|0|0|0|0|0|0|0|0|0|0|0`60|60|60|60|60|60|60|60|60|60|60|60|60|60|60|60|60|60`156494`21`30`156494`21`0`56
22`0|0|0|0|0|0|0|0|0|0|0|0|0|0|0|0|0|0`59|59|59|59|59|59|59|59|59|59|59|59|59|59|59|59|59|59`0|0|0|0|0|0|0|0|0|0|0|0|0|0|0|0|0|0`59|59|59|59|59|59|59|59|59|59|59|59|59|59|59|59|59|59`0|0|0|0|0|0|0|0|0|0|0|0|0|0|0|0|0|0`60|60|60|60|60|60|60|60|60|60|60|60|60|60|60|60|60|60`0|0|0|0|0|0|0|0|0|0|0|0|0|0|0|0|0|0`61|61|61|61|61|61|61|61|61|61|61|61|61|61|61|61|61|61`0|0|0|0|0|0|0|0|0|0|0|0|0|0|0|0|0|0`63|63|63|63|63|63|63|63|63|63|63|63|63|63|63|63|63|63`0|0|0|0|0|0|0|0|0|0|0|0|0|0|0|0|0|0`63|63|63|63|63|63|63|63|63|63|63|63|63|63|63|63|63|63`185383`22`30`185383`22`0`59
23`0|0|0|0|0|0|0|0|0|0|0|0|0|0|0|0|0|0`62|62|62|62|62|62|62|62|62|62|62|62|62|62|62|62|62|62`0|0|0|0|0|0|0|0|0|0|0|0|0|0|0|0|0|0`62|62|62|62|62|62|62|62|62|62|62|62|62|62|62|62|62|62`0|0|0|0|0|0|0|0|0|0|0|0|0|0|0|0|0|0`63|63|63|63|63|63|63|63|63|63|63|63|63|63|63|63|63|63`0|0|0|0|0|0|0|0|0|0|0|0|0|0|0|0|0|0`64|64|64|64|64|64|64|64|64|64|64|64|64|64|64|64|64|64`0|0|0|0|0|0|0|0|0|0|0|0|0|0|0|0|0|0`66|66|66|66|66|66|66|66|66|66|66|66|66|66|66|66|66|66`0|0|0|0|0|0|0|0|0|0|0|0|0|0|0|0|0|0`66|66|66|66|66|66|66|66|66|66|66|66|66|66|66|66|66|66`188949`23`30`188949`23`0`62
24`0|0|0|0|0|0|0|0|0|0|0|0|0|0|0|0|0|0`65|65|65|65|65|65|65|65|65|65|65|65|65|65|65|65|65|65`0|0|0|0|0|0|0|0|0|0|0|0|0|0|0|0|0|0`65|65|65|65|65|65|65|65|65|65|65|65|65|65|65|65|65|65`0|0|0|0|0|0|0|0|0|0|0|0|0|0|0|0|0|0`66|66|66|66|66|66|66|66|66|66|66|66|66|66|66|66|66|66`0|0|0|0|0|0|0|0|0|0|0|0|0|0|0|0|0|0`67|67|67|67|67|67|67|67|67|67|67|67|67|67|67|67|67|67`0|0|0|0|0|0|0|0|0|0|0|0|0|0|0|0|0|0`69|69|69|69|69|69|69|69|69|69|69|69|69|69|69|69|69|69`0|0|0|0|0|0|0|0|0|0|0|0|0|0|0|0|0|0`69|69|69|69|69|69|69|69|69|69|69|69|69|69|69|69|69|69`192514`24`30`192514`24`0`65
25`0|0|0|0|0|0|0|0|0|0|0|0|0|0|0|0|0|0`67|67|67|67|67|67|67|67|67|67|67|67|67|67|67|67|67|67`0|0|0|0|0|0|0|0|0|0|0|0|0|0|0|0|0|0`67|67|67|67|67|67|67|67|67|67|67|67|67|67|67|67|67|67`0|0|0|0|0|0|0|0|0|0|0|0|0|0|0|0|0|0`68|68|68|68|68|68|68|68|68|68|68|68|68|68|68|68|68|68`0|0|0|0|0|0|0|0|0|0|0|0|0|0|0|0|0|0`69|69|69|69|69|69|69|69|69|69|69|69|69|69|69|69|69|69`0|0|0|0|0|0|0|0|0|0|0|0|0|0|0|0|0|0`71|71|71|71|71|71|71|71|71|71|71|71|71|71|71|71|71|71`0|0|0|0|0|0|0|0|0|0|0|0|0|0|0|0|0|0`71|71|71|71|71|71|71|71|71|71|71|71|71|71|71|71|71|71`196078`25`30`196078`25`0`67
26`0|0|0|0|0|0|0|0|0|0|0|0|0|0|0|0|0|0`70|70|70|70|70|70|70|70|70|70|70|70|70|70|70|70|70|70`0|0|0|0|0|0|0|0|0|0|0|0|0|0|0|0|0|0`70|70|70|70|70|70|70|70|70|70|70|70|70|70|70|70|70|70`0|0|0|0|0|0|0|0|0|0|0|0|0|0|0|0|0|0`71|71|71|71|71|71|71|71|71|71|71|71|71|71|71|71|71|71`0|0|0|0|0|0|0|0|0|0|0|0|0|0|0|0|0|0`72|72|72|72|72|72|72|72|72|72|72|72|72|72|72|72|72|72`0|0|0|0|0|0|0|0|0|0|0|0|0|0|0|0|0|0`74|74|74|74|74|74|74|74|74|74|74|74|74|74|74|74|74|74`0|0|0|0|0|0|0|0|0|0|0|0|0|0|0|0|0|0`74|74|74|74|74|74|74|74|74|74|74|74|74|74|74|74|74|74`227454`26`30`227454`26`0`70
27`0|0|0|0|0|0|0|0|0|0|0|0|0|0|0|0|0|0`73|73|73|73|73|73|73|73|73|73|73|73|73|73|73|73|73|73`0|0|0|0|0|0|0|0|0|0|0|0|0|0|0|0|0|0`73|73|73|73|73|73|73|73|73|73|73|73|73|73|73|73|73|73`0|0|0|0|0|0|0|0|0|0|0|0|0|0|0|0|0|0`74|74|74|74|74|74|74|74|74|74|74|74|74|74|74|74|74|74`0|0|0|0|0|0|0|0|0|0|0|0|0|0|0|0|0|0`75|75|75|75|75|75|75|75|75|75|75|75|75|75|75|75|75|75`0|0|0|0|0|0|0|0|0|0|0|0|0|0|0|0|0|0`77|77|77|77|77|77|77|77|77|77|77|77|77|77|77|77|77|77`0|0|0|0|0|0|0|0|0|0|0|0|0|0|0|0|0|0`77|77|77|77|77|77|77|77|77|77|77|77|77|77|77|77|77|77`231516`27`30`231516`27`0`73
28`0|0|0|0|0|0|0|0|0|0|0|0|0|0|0|0|0|0`75|75|75|75|75|75|75|75|75|75|75|75|75|75|75|75|75|75`0|0|0|0|0|0|0|0|0|0|0|0|0|0|0|0|0|0`75|75|75|75|75|75|75|75|75|75|75|75|75|75|75|75|75|75`0|0|0|0|0|0|0|0|0|0|0|0|0|0|0|0|0|0`76|76|76|76|76|76|76|76|76|76|76|76|76|76|76|76|76|76`0|0|0|0|0|0|0|0|0|0|0|0|0|0|0|0|0|0`77|77|77|77|77|77|77|77|77|77|77|77|77|77|77|77|77|77`0|0|0|0|0|0|0|0|0|0|0|0|0|0|0|0|0|0`79|79|79|79|79|79|79|79|79|79|79|79|79|79|79|79|79|79`0|0|0|0|0|0|0|0|0|0|0|0|0|0|0|0|0|0`79|79|79|79|79|79|79|79|79|79|79|79|79|79|79|79|79|79`235578`28`30`235578`28`0`75
29`0|0|0|0|0|0|0|0|0|0|0|0|0|0|0|0|0|0`78|78|78|78|78|78|78|78|78|78|78|78|78|78|78|78|78|78`0|0|0|0|0|0|0|0|0|0|0|0|0|0|0|0|0|0`78|78|78|78|78|78|78|78|78|78|78|78|78|78|78|78|78|78`0|0|0|0|0|0|0|0|0|0|0|0|0|0|0|0|0|0`79|79|79|79|79|79|79|79|79|79|79|79|79|79|79|79|79|79`0|0|0|0|0|0|0|0|0|0|0|0|0|0|0|0|0|0`80|80|80|80|80|80|80|80|80|80|80|80|80|80|80|80|80|80`0|0|0|0|0|0|0|0|0|0|0|0|0|0|0|0|0|0`82|82|82|82|82|82|82|82|82|82|82|82|82|82|82|82|82|82`0|0|0|0|0|0|0|0|0|0|0|0|0|0|0|0|0|0`82|82|82|82|82|82|82|82|82|82|82|82|82|82|82|82|82|82`268939`29`30`268939`29`0`78
30`0|0|0|0|0|0|0|0|0|0|0|0|0|0|0|0|0|0`80|80|80|80|80|80|80|80|80|80|80|80|80|80|80|80|80|80`0|0|0|0|0|0|0|0|0|0|0|0|0|0|0|0|0|0`80|80|80|80|80|80|80|80|80|80|80|80|80|80|80|80|80|80`0|0|0|0|0|0|0|0|0|0|0|0|0|0|0|0|0|0`81|81|81|81|81|81|81|81|81|81|81|81|81|81|81|81|81|81`0|0|0|0|0|0|0|0|0|0|0|0|0|0|0|0|0|0`82|82|82|82|82|82|82|82|82|82|82|82|82|82|82|82|82|82`0|0|0|0|0|0|0|0|0|0|0|0|0|0|0|0|0|0`84|84|84|84|84|84|84|84|84|84|84|84|84|84|84|84|84|84`0|0|0|0|0|0|0|0|0|0|0|0|0|0|0|0|0|0`84|84|84|84|84|84|84|84|84|84|84|84|84|84|84|84|84|84`273498`30`30`273498`30`0`80
31`0|0|0|0|0|0|0|0|0|0|0|0|0|0|0|0|0|0`83|83|83|83|83|83|83|83|83|83|83|83|83|83|83|83|83|83`0|0|0|0|0|0|0|0|0|0|0|0|0|0|0|0|0|0`83|83|83|83|83|83|83|83|83|83|83|83|83|83|83|83|83|83`0|0|0|0|0|0|0|0|0|0|0|0|0|0|0|0|0|0`84|84|84|84|84|84|84|84|84|84|84|84|84|84|84|84|84|84`0|0|0|0|0|0|0|0|0|0|0|0|0|0|0|0|0|0`85|85|85|85|85|85|85|85|85|85|85|85|85|85|85|85|85|85`0|0|0|0|0|0|0|0|0|0|0|0|0|0|0|0|0|0`87|87|87|87|87|87|87|87|87|87|87|87|87|87|87|87|87|87`0|0|0|0|0|0|0|0|0|0|0|0|0|0|0|0|0|0`87|87|87|87|87|87|87|87|87|87|87|87|87|87|87|87|87|87`278056`31`30`278056`31`0`83
32`0|0|0|0|0|0|0|0|0|0|0|0|0|0|0|0|0|0`88|88|88|88|88|88|88|88|88|88|88|88|88|88|88|88|88|88`0|0|0|0|0|0|0|0|0|0|0|0|0|0|0|0|0|0`88|88|88|88|88|88|88|88|88|88|88|88|88|88|88|88|88|88`0|0|0|0|0|0|0|0|0|0|0|0|0|0|0|0|0|0`89|89|89|89|89|89|89|89|89|89|89|89|89|89|89|89|89|89`0|0|0|0|0|0|0|0|0|0|0|0|0|0|0|0|0|0`90|90|90|90|90|90|90|90|90|90|90|90|90|90|90|90|90|90`0|0|0|0|0|0|0|0|0|0|0|0|0|0|0|0|0|0`92|92|92|92|92|92|92|92|92|92|92|92|92|92|92|92|92|92`0|0|0|0|0|0|0|0|0|0|0|0|0|0|0|0|0|0`92|92|92|92|92|92|92|92|92|92|92|92|92|92|92|92|92|92`282614`32`30`282614`32`0`88
33`0|0|0|0|0|0|0|0|0|0|0|0|0|0|0|0|0|0`90|90|90|90|90|90|90|90|90|90|90|90|90|90|90|90|90|90`0|0|0|0|0|0|0|0|0|0|0|0|0|0|0|0|0|0`90|90|90|90|90|90|90|90|90|90|90|90|90|90|90|90|90|90`0|0|0|0|0|0|0|0|0|0|0|0|0|0|0|0|0|0`91|91|91|91|91|91|91|91|91|91|91|91|91|91|91|91|91|91`0|0|0|0|0|0|0|0|0|0|0|0|0|0|0|0|0|0`92|92|92|92|92|92|92|92|92|92|92|92|92|92|92|92|92|92`0|0|0|0|0|0|0|0|0|0|0|0|0|0|0|0|0|0`94|94|94|94|94|94|94|94|94|94|94|94|94|94|94|94|94|94`0|0|0|0|0|0|0|0|0|0|0|0|0|0|0|0|0|0`94|94|94|94|94|94|94|94|94|94|94|94|94|94|94|94|94|94`318456`33`30`318456`33`0`90
34`0|0|0|0|0|0|0|0|0|0|0|0|0|0|0|0|0|0`94|94|94|94|94|94|94|94|94|94|94|94|94|94|94|94|94|94`0|0|0|0|0|0|0|0|0|0|0|0|0|0|0|0|0|0`94|94|94|94|94|94|94|94|94|94|94|94|94|94|94|94|94|94`0|0|0|0|0|0|0|0|0|0|0|0|0|0|0|0|0|0`95|95|95|95|95|95|95|95|95|95|95|95|95|95|95|95|95|95`0|0|0|0|0|0|0|0|0|0|0|0|0|0|0|0|0|0`96|96|96|96|96|96|96|96|96|96|96|96|96|96|96|96|96|96`0|0|0|0|0|0|0|0|0|0|0|0|0|0|0|0|0|0`98|98|98|98|98|98|98|98|98|98|98|98|98|98|98|98|98|98`0|0|0|0|0|0|0|0|0|0|0|0|0|0|0|0|0|0`98|98|98|98|98|98|98|98|98|98|98|98|98|98|98|98|98|98`323511`34`30`323511`34`0`94
35`0|0|0|0|0|0|0|0|0|0|0|0|0|0|0|0|0|0`96|96|96|96|96|96|96|96|96|96|96|96|96|96|96|96|96|96`0|0|0|0|0|0|0|0|0|0|0|0|0|0|0|0|0|0`96|96|96|96|96|96|96|96|96|96|96|96|96|96|96|96|96|96`0|0|0|0|0|0|0|0|0|0|0|0|0|0|0|0|0|0`97|97|97|97|97|97|97|97|97|97|97|97|97|97|97|97|97|97`0|0|0|0|0|0|0|0|0|0|0|0|0|0|0|0|0|0`98|98|98|98|98|98|98|98|98|98|98|98|98|98|98|98|98|98`0|0|0|0|0|0|0|0|0|0|0|0|0|0|0|0|0|0`99|99|99|99|99|99|99|99|99|99|99|99|99|99|99|99|99|99`0|0|0|0|0|0|0|0|0|0|0|0|0|0|0|0|0|0`99|99|99|99|99|99|99|99|99|99|99|99|99|99|99|99|99|99`328566`35`30`328566`35`0`96
36`1|1|1|1|1|1|1|1|1|1|1|1|1|1|1|1|1|1`86|86|86|86|86|86|86|86|86|86|86|86|86|86|86|86|86|86`1|1|1|1|1|1|1|1|1|1|1|1|1|1|1|1|1|1`86|86|86|86|86|86|86|86|86|86|86|86|86|86|86|86|86|86`1|1|1|1|1|1|1|1|1|1|1|1|1|1|1|1|1|1`87|87|87|87|87|87|87|87|87|87|87|87|87|87|87|87|87|87`1|1|1|1|1|1|1|1|1|1|1|1|1|1|1|1|1|1`88|88|88|88|88|88|88|88|88|88|88|88|88|88|88|88|88|88`1|1|1|1|1|1|1|1|1|1|1|1|1|1|1|1|1|1`90|90|90|90|90|90|90|90|90|90|90|90|90|90|90|90|90|90`1|1|1|1|1|1|1|1|1|1|1|1|1|1|1|1|1|1`90|90|90|90|90|90|90|90|90|90|90|90|90|90|90|90|90|90`366397`36`30`366397`36`1`86
37`1|1|1|1|1|1|1|1|1|1|1|1|1|1|1|1|1|1`88|88|88|88|88|88|88|88|88|88|88|88|88|88|88|88|88|88`1|1|1|1|1|1|1|1|1|1|1|1|1|1|1|1|1|1`88|88|88|88|88|88|88|88|88|88|88|88|88|88|88|88|88|88`1|1|1|1|1|1|1|1|1|1|1|1|1|1|1|1|1|1`89|89|89|89|89|89|89|89|89|89|89|89|89|89|89|89|89|89`1|1|1|1|1|1|1|1|1|1|1|1|1|1|1|1|1|1`90|90|90|90|90|90|90|90|90|90|90|90|90|90|90|90|90|90`1|1|1|1|1|1|1|1|1|1|1|1|1|1|1|1|1|1`92|92|92|92|92|92|92|92|92|92|92|92|92|92|92|92|92|92`1|1|1|1|1|1|1|1|1|1|1|1|1|1|1|1|1|1`92|92|92|92|92|92|92|92|92|92|92|92|92|92|92|92|92|92`371948`37`30`371948`37`1`88
38`1|1|1|1|1|1|1|1|1|1|1|1|1|1|1|1|1|1`90|90|90|90|90|90|90|90|90|90|90|90|90|90|90|90|90|90`1|1|1|1|1|1|1|1|1|1|1|1|1|1|1|1|1|1`90|90|90|90|90|90|90|90|90|90|90|90|90|90|90|90|90|90`1|1|1|1|1|1|1|1|1|1|1|1|1|1|1|1|1|1`91|91|91|91|91|91|91|91|91|91|91|91|91|91|91|91|91|91`1|1|1|1|1|1|1|1|1|1|1|1|1|1|1|1|1|1`92|92|92|92|92|92|92|92|92|92|92|92|92|92|92|92|92|92`1|1|1|1|1|1|1|1|1|1|1|1|1|1|1|1|1|1`94|94|94|94|94|94|94|94|94|94|94|94|94|94|94|94|94|94`1|1|1|1|1|1|1|1|1|1|1|1|1|1|1|1|1|1`94|94|94|94|94|94|94|94|94|94|94|94|94|94|94|94|94|94`377500`38`30`377500`38`1`90
39`1|1|1|1|1|1|1|1|1|1|1|1|1|1|1|1|1|1`99|99|99|99|99|99|99|99|99|99|99|99|99|99|99|99|99|99`1|1|1|1|1|1|1|1|1|1|1|1|1|1|1|1|1|1`99|99|99|99|99|99|99|99|99|99|99|99|99|99|99|99|99|99`1|1|1|1|1|1|1|1|1|1|1|1|1|1|1|1|1|1`99|99|99|99|99|99|99|99|99|99|99|99|99|99|99|99|99|99`1|1|1|1|1|1|1|1|1|1|1|1|1|1|1|1|1|1`99|99|99|99|99|99|99|99|99|99|99|99|99|99|99|99|99|99`1|1|1|1|1|1|1|1|1|1|1|1|1|1|1|1|1|1`99|99|99|99|99|99|99|99|99|99|99|99|99|99|99|99|99|99`1|1|1|1|1|1|1|1|1|1|1|1|1|1|1|1|1|1`99|99|99|99|99|99|99|99|99|99|99|99|99|99|99|99|99|99`383052`39`30`383052`39`1`99
40`2|2|2|2|2|2|2|2|2|2|2|2|2|2|2|2|2|2`72|72|72|72|72|72|72|72|72|72|72|72|72|72|72|72|72|72`2|2|2|2|2|2|2|2|2|2|2|2|2|2|2|2|2|2`72|72|72|72|72|72|72|72|72|72|72|72|72|72|72|72|72|72`2|2|2|2|2|2|2|2|2|2|2|2|2|2|2|2|2|2`73|73|73|73|73|73|73|73|73|73|73|73|73|73|73|73|73|73`2|2|2|2|2|2|2|2|2|2|2|2|2|2|2|2|2|2`74|74|74|74|74|74|74|74|74|74|74|74|74|74|74|74|74|74`2|2|2|2|2|2|2|2|2|2|2|2|2|2|2|2|2|2`76|76|76|76|76|76|76|76|76|76|76|76|76|76|76|76|76|76`2|2|2|2|2|2|2|2|2|2|2|2|2|2|2|2|2|2`76|76|76|76|76|76|76|76|76|76|76|76|76|76|76|76|76|76`423366`40`30`423366`40`2`72
41`2|2|2|2|2|2|2|2|2|2|2|2|2|2|2|2|2|2`99|99|99|99|99|99|99|99|99|99|99|99|99|99|99|99|99|99`2|2|2|2|2|2|2|2|2|2|2|2|2|2|2|2|2|2`99|99|99|99|99|99|99|99|99|99|99|99|99|99|99|99|99|99`2|2|2|2|2|2|2|2|2|2|2|2|2|2|2|2|2|2`99|99|99|99|99|99|99|99|99|99|99|99|99|99|99|99|99|99`2|2|2|2|2|2|2|2|2|2|2|2|2|2|2|2|2|2`99|99|99|99|99|99|99|99|99|99|99|99|99|99|99|99|99|99`2|2|2|2|2|2|2|2|2|2|2|2|2|2|2|2|2|2`99|99|99|99|99|99|99|99|99|99|99|99|99|99|99|99|99|99`2|2|2|2|2|2|2|2|2|2|2|2|2|2|2|2|2|2`99|99|99|99|99|99|99|99|99|99|99|99|99|99|99|99|99|99`429414`41`30`429414`41`2`99
42`3|3|3|3|3|3|3|3|3|3|3|3|3|3|3|3|3|3`70|70|70|70|70|70|70|70|70|70|70|70|70|70|70|70|70|70`3|3|3|3|3|3|3|3|3|3|3|3|3|3|3|3|3|3`70|70|70|70|70|70|70|70|70|70|70|70|70|70|70|70|70|70`3|3|3|3|3|3|3|3|3|3|3|3|3|3|3|3|3|3`71|71|71|71|71|71|71|71|71|71|71|71|71|71|71|71|71|71`3|3|3|3|3|3|3|3|3|3|3|3|3|3|3|3|3|3`72|72|72|72|72|72|72|72|72|72|72|72|72|72|72|72|72|72`3|3|3|3|3|3|3|3|3|3|3|3|3|3|3|3|3|3`74|74|74|74|74|74|74|74|74|74|74|74|74|74|74|74|74|74`3|3|3|3|3|3|3|3|3|3|3|3|3|3|3|3|3|3`74|74|74|74|74|74|74|74|74|74|74|74|74|74|74|74|74|74`435462`42`30`435462`42`3`70
43`3|3|3|3|3|3|3|3|3|3|3|3|3|3|3|3|3|3`74|74|74|74|74|74|74|74|74|74|74|74|74|74|74|74|74|74`3|3|3|3|3|3|3|3|3|3|3|3|3|3|3|3|3|3`74|74|74|74|74|74|74|74|74|74|74|74|74|74|74|74|74|74`3|3|3|3|3|3|3|3|3|3|3|3|3|3|3|3|3|3`75|75|75|75|75|75|75|75|75|75|75|75|75|75|75|75|75|75`3|3|3|3|3|3|3|3|3|3|3|3|3|3|3|3|3|3`76|76|76|76|76|76|76|76|76|76|76|76|76|76|76|76|76|76`3|3|3|3|3|3|3|3|3|3|3|3|3|3|3|3|3|3`78|78|78|78|78|78|78|78|78|78|78|78|78|78|78|78|78|78`3|3|3|3|3|3|3|3|3|3|3|3|3|3|3|3|3|3`78|78|78|78|78|78|78|78|78|78|78|78|78|78|78|78|78|78`441510`43`30`441510`43`3`74
44`3|3|3|3|3|3|3|3|3|3|3|3|3|3|3|3|3|3`79|79|79|79|79|79|79|79|79|79|79|79|79|79|79|79|79|79`3|3|3|3|3|3|3|3|3|3|3|3|3|3|3|3|3|3`79|79|79|79|79|79|79|79|79|79|79|79|79|79|79|79|79|79`3|3|3|3|3|3|3|3|3|3|3|3|3|3|3|3|3|3`80|80|80|80|80|80|80|80|80|80|80|80|80|80|80|80|80|80`3|3|3|3|3|3|3|3|3|3|3|3|3|3|3|3|3|3`81|81|81|81|81|81|81|81|81|81|81|81|81|81|81|81|81|81`3|3|3|3|3|3|3|3|3|3|3|3|3|3|3|3|3|3`83|83|83|83|83|83|83|83|83|83|83|83|83|83|83|83|83|83`3|3|3|3|3|3|3|3|3|3|3|3|3|3|3|3|3|3`83|83|83|83|83|83|83|83|83|83|83|83|83|83|83|83|83|83`447558`44`30`447558`44`3`79
45`3|3|3|3|3|3|3|3|3|3|3|3|3|3|3|3|3|3`81|81|81|81|81|81|81|81|81|81|81|81|81|81|81|81|81|81`3|3|3|3|3|3|3|3|3|3|3|3|3|3|3|3|3|3`81|81|81|81|81|81|81|81|81|81|81|81|81|81|81|81|81|81`3|3|3|3|3|3|3|3|3|3|3|3|3|3|3|3|3|3`82|82|82|82|82|82|82|82|82|82|82|82|82|82|82|82|82|82`3|3|3|3|3|3|3|3|3|3|3|3|3|3|3|3|3|3`83|83|83|83|83|83|83|83|83|83|83|83|83|83|83|83|83|83`3|3|3|3|3|3|3|3|3|3|3|3|3|3|3|3|3|3`85|85|85|85|85|85|85|85|85|85|85|85|85|85|85|85|85|85`3|3|3|3|3|3|3|3|3|3|3|3|3|3|3|3|3|3`85|85|85|85|85|85|85|85|85|85|85|85|85|85|85|85|85|85`453606`45`30`453606`45`3`81
46`3|3|3|3|3|3|3|3|3|3|3|3|3|3|3|3|3|3`85|85|85|85|85|85|85|85|85|85|85|85|85|85|85|85|85|85`3|3|3|3|3|3|3|3|3|3|3|3|3|3|3|3|3|3`85|85|85|85|85|85|85|85|85|85|85|85|85|85|85|85|85|85`3|3|3|3|3|3|3|3|3|3|3|3|3|3|3|3|3|3`86|86|86|86|86|86|86|86|86|86|86|86|86|86|86|86|86|86`3|3|3|3|3|3|3|3|3|3|3|3|3|3|3|3|3|3`87|87|87|87|87|87|87|87|87|87|87|87|87|87|87|87|87|87`3|3|3|3|3|3|3|3|3|3|3|3|3|3|3|3|3|3`89|89|89|89|89|89|89|89|89|89|89|89|89|89|89|89|89|89`3|3|3|3|3|3|3|3|3|3|3|3|3|3|3|3|3|3`89|89|89|89|89|89|89|89|89|89|89|89|89|89|89|89|89|89`459654`46`30`459654`46`3`85
47`3|3|3|3|3|3|3|3|3|3|3|3|3|3|3|3|3|3`89|89|89|89|89|89|89|89|89|89|89|89|89|89|89|89|89|89`3|3|3|3|3|3|3|3|3|3|3|3|3|3|3|3|3|3`89|89|89|89|89|89|89|89|89|89|89|89|89|89|89|89|89|89`3|3|3|3|3|3|3|3|3|3|3|3|3|3|3|3|3|3`90|90|90|90|90|90|90|90|90|90|90|90|90|90|90|90|90|90`3|3|3|3|3|3|3|3|3|3|3|3|3|3|3|3|3|3`91|91|91|91|91|91|91|91|91|91|91|91|91|91|91|91|91|91`3|3|3|3|3|3|3|3|3|3|3|3|3|3|3|3|3|3`93|93|93|93|93|93|93|93|93|93|93|93|93|93|93|93|93|93`3|3|3|3|3|3|3|3|3|3|3|3|3|3|3|3|3|3`93|93|93|93|93|93|93|93|93|93|93|93|93|93|93|93|93|93`465702`47`30`465702`47`3`89
48`3|3|3|3|3|3|3|3|3|3|3|3|3|3|3|3|3|3`92|92|92|92|92|92|92|92|92|92|92|92|92|92|92|92|92|92`3|3|3|3|3|3|3|3|3|3|3|3|3|3|3|3|3|3`92|92|92|92|92|92|92|92|92|92|92|92|92|92|92|92|92|92`3|3|3|3|3|3|3|3|3|3|3|3|3|3|3|3|3|3`93|93|93|93|93|93|93|93|93|93|93|93|93|93|93|93|93|93`3|3|3|3|3|3|3|3|3|3|3|3|3|3|3|3|3|3`94|94|94|94|94|94|94|94|94|94|94|94|94|94|94|94|94|94`3|3|3|3|3|3|3|3|3|3|3|3|3|3|3|3|3|3`96|96|96|96|96|96|96|96|96|96|96|96|96|96|96|96|96|96`3|3|3|3|3|3|3|3|3|3|3|3|3|3|3|3|3|3`96|96|96|96|96|96|96|96|96|96|96|96|96|96|96|96|96|96`471750`48`30`471750`48`3`92
49`3|3|3|3|3|3|3|3|3|3|3|3|3|3|3|3|3|3`96|96|96|96|96|96|96|96|96|96|96|96|96|96|96|96|96|96`3|3|3|3|3|3|3|3|3|3|3|3|3|3|3|3|3|3`96|96|96|96|96|96|96|96|96|96|96|96|96|96|96|96|96|96`3|3|3|3|3|3|3|3|3|3|3|3|3|3|3|3|3|3`97|97|97|97|97|97|97|97|97|97|97|97|97|97|97|97|97|97`3|3|3|3|3|3|3|3|3|3|3|3|3|3|3|3|3|3`98|98|98|98|98|98|98|98|98|98|98|98|98|98|98|98|98|98`3|3|3|3|3|3|3|3|3|3|3|3|3|3|3|3|3|3`99|99|99|99|99|99|99|99|99|99|99|99|99|99|99|99|99|99`3|3|3|3|3|3|3|3|3|3|3|3|3|3|3|3|3|3`99|99|99|99|99|99|99|99|99|99|99|99|99|99|99|99|99|99`477798`49`30`477798`49`3`96
50`3|3|3|3|3|3|3|3|3|3|3|3|3|3|3|3|3|3`99|99|99|99|99|99|99|99|99|99|99|99|99|99|99|99|99|99`3|3|3|3|3|3|3|3|3|3|3|3|3|3|3|3|3|3`99|99|99|99|99|99|99|99|99|99|99|99|99|99|99|99|99|99`3|3|3|3|3|3|3|3|3|3|3|3|3|3|3|3|3|3`99|99|99|99|99|99|99|99|99|99|99|99|99|99|99|99|99|99`3|3|3|3|3|3|3|3|3|3|3|3|3|3|3|3|3|3`99|99|99|99|99|99|99|99|99|99|99|99|99|99|99|99|99|99`3|3|3|3|3|3|3|3|3|3|3|3|3|3|3|3|3|3`99|99|99|99|99|99|99|99|99|99|99|99|99|99|99|99|99|99`3|3|3|3|3|3|3|3|3|3|3|3|3|3|3|3|3|3`99|99|99|99|99|99|99|99|99|99|99|99|99|99|99|99|99|99`483846`50`30`483846`50`3`99